8.ox
........
...o....
..oooo..
........
........
...o....
........
.....o.o
